#	#	#	#	#	#	#	#	#	#	#	#	#	#	#	#	#	#
#	#	#	#	#	R	#	#	#	#	#	R	#	#	#	#	#	#
#	#	#	#	#	#	#	#	#	#	#	#	#	#	#	#	#	#
#	#	#	#	#	#	#	#	R	#	#	#	#	#	#	#	#	#
Hb	#	#	Ub	#	#	#	#	#	#	#	#	#	#	Ur	#	#	Hr
#	Fb	#	#	Db	#	#	#	#	#	#	#	#	Dr	#	#	Fr	#
#	#	#	Sb	#	#	#	#	#	#	#	#	#	#	Sr	#	#	#
#	#	#	#	#	#	#	#	R	#	#	#	#	#	#	#	#	#
#	#	#	#	#	#	#	#	#	#	#	#	#	#	#	#	#	#
#	#	#	#	#	R	#	#	#	#	#	R	#	#	#	#	#	#
#	#	#	#	#	#	#	#	#	#	#	#	#	#	#	#	#	#