#	#	#	#	#	#	#	#	#	#
#	#	Rb	#	#	#	#	Rr	#	#
#	#	#	#	#	#	#	#	#	#
#	#	#	Db	#	#	Dr	#	#	#
#	Fb	#	Ub	#	#	Ur	#	Fr	#
#	#	#	Db	#	#	Dr	#	#	#
#	#	Rb	#	#	#	#	Rr	#	#
#	#	#	#	#	#	#	#	#	#