#	#	#	#	#	#	#	#	#	#	#	#	#	#	#	#	#	#
#	#	#	#	#	R	#	#	#	#	#	R	#	#	#	#	#	#
#	#	#	#	#	#	#	#	#	#	#	#	#	#	#	#	#	#
#	#	#	#	#	#	#	#	R	#	#	#	#	#	#	#	#	#
#	#	#	Ub	#	#	#	#	#	#	#	#	#	#	Ur	#	#	#
#	Fb	#	#	Db	#	#	#	#	#	#	#	#	Dr	#	#	Fr	#
#	#	#	Ub	#	#	#	#	#	#	#	#	#	#	Ur	#	#	#
#	#	#	#	#	#	#	#	R	#	#	#	#	#	#	#	#	#
#	#	#	#	#	#	#	#	#	#	#	#	#	#	#	#	#	#
#	#	#	#	#	R	#	#	#	#	#	R	#	#	#	#	#	#
#	#	#	#	#	#	#	#	#	#	#	#	#	#	#	#	#	#