#	#	#	#	#	#	#	#	#	#	#	#	#	#	#	#	#	#
#	#	#	#	#	R	#	#	#	#	#	R	#	#	#	#	#	#
#	#	#	#	#	#	#	#	#	#	#	#	#	#	#	#	#	#
#	#	#	#	#	#	#	#	R	#	#	#	#	#	#	#	#	#
Hb	#	#	Ub	#	#	#	#	#	#	#	#	#	#	Ur	#	#	Hr
#	Fb	#	#	Db	#	#	#	#	#	#	#	#	Dr	#	#	Fr	#
#	#	#	Ub	#	#	#	#	#	#	#	#	#	#	Ur	#	#	#
#	#	#	#	#	#	#	#	R	#	#	#	#	#	#	#	#	#
#	#	#	#	#	#	#	#	#	#	#	#	#	#	#	#	#	#
#	#	#	#	#	R	#	#	#	#	#	R	#	#	#	#	#	#
#	#	#	#	#	#	#	#	#	#	#	#	#	#	#	#	#	#