#	#	#	#	#	#	#	#	#	#	#	#	#	#	#	#	#	#	#
#	#	#	#	#	R	#	#	#	#	#	#	#	R	#	#	#	#	#
#	#	#	#	#	#	#	#	#	#	#	#	#	#	#	#	#	#	#
#	#	#	Ub	#	#	#	#	#	R	#	#	#	#	#	Ur	#	#	#
Hb	#	#	#	#	#	#	#	#	#	#	#	#	#	#	#	#	#	Hr
#	Fb	#	#	Db	#	#	#	#	G	#	#	#	#	Dr	#	#	Fr	#
#	#	#	#	#	#	#	#	#	#	#	#	#	#	#	#	#	#	#
#	#	#	Ub	#	#	#	#	#	R	#	#	#	#	#	Ur	#	#	#
#	#	#	#	#	#	#	#	#	#	#	#	#	#	#	#	#	#	#
#	#	#	#	#	R	#	#	#	#	#	#	#	R	#	#	#	#	#
#	#	#	#	#	#	#	#	#	#	#	#	#	#	#	#	#	#	#