#	#	#	#	#	#	#	#	#	#
#	#	R	#	#	#	#	R	#	#
#	#	#	#	#	#	#	#	#	#
#	#	#	Db	#	#	Dr	#	#	#
#	Fb	#	Ub	#	#	Ur	#	Fr	#
#	#	#	Db	#	#	Dr	#	#	#
#	#	R	#	#	#	#	R	#	#
#	#	#	#	#	#	#	#	#	#