#	#	#	#	#	#	#	#	#	#	#	#	#	#	#	#	#	#	#
#	#	#	#	#	R	#	#	#	#	#	#	#	R	#	#	#	#	#
#	#	#	#	#	#	#	#	#	#	#	#	#	#	#	#	#	#	#
#	#	#	#	#	#	#	#	#	R	#	#	#	#	#	#	#	#	#
Hb	#	#	Ub	#	#	#	#	#	#	#	#	#	#	#	Ur	#	#	Hr
#	Fb	#	#	Db	#	#	#	#	G	#	#	#	#	Dr	#	#	Fr	#
#	#	#	Ub	#	#	#	#	#	#	#	#	#	#	#	Ur	#	#	#
#	#	#	#	#	#	#	#	#	R	#	#	#	#	#	#	#	#	#
#	#	#	#	#	#	#	#	#	#	#	#	#	#	#	#	#	#	#
#	#	#	#	#	R	#	#	#	#	#	#	#	R	#	#	#	#	#
#	#	#	#	#	#	#	#	#	#	#	#	#	#	#	#	#	#	#